EA ./assets/wall_ea.xpm
SO   ./assets/wall_so.xpm  
               
WE             ./assets/wall_we.xpm

      NO ./assets/wall_no.xpm                      
           
       


F 33,2,1                
C    1,    250,   250 





11

   1111111111111111
11111111111111111
100010000000001    
1000001111111111111111        1
10000010000000000000011
10000000001000N000000111
1000001000000000000001
1011111111111111111111
101
111                 1

1





