NO ./assets/wall_no.xpm
SO        ./assets/wall_so.xpm
WE ./assets/wall_we.xpm
EA ./assets/wall_ea.xpm

FA      019,012,014
C       190,    250,   250









   1111111111111111
11111111111111111
100010000000001
1000001111111111111111
10000010000000000000011
1000000000W000000000011
1000001000000000000001
1011111111111111111111
101
111
