NO ./assets/wall_no.xpm
SO ./assets/wall_so.xpm
WE ./assets/wall_we.xpm
EA ./assets/wall_ea.xpm

F 019,012,014
C 190,250,250

   1111111111111111
111111100000011
100000000000001
1000001111111111111111
1000001000000000000001
1000000000000000000001
1000001000W00000000001
1011111111111111111111
101
11